^^^''''''''
^^''''**'''
^^'''**''''
^''''''''''
''''~~~''''
''''~~~''''
'''~~~~''''
'''''~~~'''
'''''~~~~''
'''''''~'''
'''''''''''